Days	Leʼnjʉ
Clear	Bwə̀tə̌
Today	Sɛ̂nni
Hours	Ngə̀laŋ
Minutes	Mfenyam
Seconds	Mfenyamnkəʼə
Set Date	Diagtə leʼnjʉ
Set Time	Diagtə ngə̀laŋ
Choose Date	Ka leʼnjʉ
Choose Time	Ka ngə̀laŋ
Set Duration	Diagtə njoŋ ngə̀laŋ
Next Month	Mbadtə̀ ŋwʉ
Previous Month	Nzimbwə̀ ŋwʉ
Other Dates	Tsə̂moʼ ngə̀laŋ
Tomorrow	Ndamnjʉ
I am a pupil 	Məè bə αê ngaè ŋwaèʼni 
I am a student	Məè bə αê ngaè ŋwaèʼni 
I rest to study	Mə̌ nəè fitə ziʼ ju 
I love the leader	Mə̌ kɔ̂ ngaècaègtəè 
I have a school bag	Mə̌ ghʉ̌ bαûm ŋwaèni 
I am going to school	Mə̌ nɛèn αê ŋwaèni 
I often go to school	Məè num nɛ̂ n ŋwaèʼni 
Each with his teacher	Mbα wəloè bo zəè ngaètswitə̌ 
I have school uniform	Mə̌ ghʉ̌ nzwə̂ ŋwaèni 
I am back from school	Mə̌ fə αê ŋwaèni 
I must go to the water	Mə̌ aèʼ nɛ̌ n ntsə 
I admire the headmaster	Mə̌ kɔ̂ ngaècaègtəè 
Are you going to school	O nɛèn αê ŋwaèni 
We go out in the morning	Bαg kə ntum αê nkə̂ bnjʉ 
I have a lot of school tools	Mə̌ ghʉ̌ cu ŋwaèni yαmə 
The way to school is long	Mαênzəè ŋwaèʼni saègə 
We are often numerous on route	Bαg num njαm mαênzəè 
pupils are often numerous	Ghaŋwaèʼni num njαmə 
Students are often numerous	Ghaŋwaèʼni num njαmə 
The place of the school is far	Dʉ̌ ʼ ŋwaèʼni saègə 
The school finishes during the day	Mbwogcʉ̂ ŋwaèni mi 
Each with his teacher in a classroom	Mbα wəloè bo zəè ngaètswitə̌ ntʉ̂ m taʼ ndαê ŋwaèʼni
In the morning we will align ourselves	Nkə̂ bnjʉ bαg tsin nka 
Teachers are the most numerous at school	Ghatswitə̌ bɛ̂ n njαm dʉ̌ ʼ ŋwaèʼni 
Our school is big with a lot of classrooms	Yαg dʉ̌ ʼ ŋwaèʼni ghuʼ, ndαê ŋwaèʼni yαm bwə
At night I will sleep	Tɛdtswəʼ, mə zi 
Tomorrow, I will go to school	Ndamnjʉ, mə nɛ̂ n ŋwaèʼni 
Have you had a good night Sir? 	O zi lα tα? 
Have you had a good night daddy? 	O zi lα tα? 
Good morning daddy	O zi lα tα? 
Good morning mum	O zi lα mα? 
Have you had a good night mummy? 	O zi lα mα? 
Have you had a good night madam? 	O zi lα mα? 
I greeted my daddy	Mə caèʼtə̌ tα αê 
I greeted my mummy	Mə caèʼtə̌ mα αê 
Sir, did you sleep well?	Tα, o zi məèbwɔ αè? 
Daddy, did you sleep well?	Tα, o zi məèbwɔ αè? 
Yes, my son	Ŋ̂ , mə mɛ̂ n αèm 
We are going to school	Bαg nɛn αê ŋwaèʼni 
Good bye Sir	Ɔ ɔ tα 
Good bye daddy	Ɔ ɔ tα 
Good bye madam	Ɔ ɔ mα 
Good bye mummy	Ɔ ɔ mα 
We coming home from school	Bαg fə αê ŋwaèʼni 
Did you have a good day daddy?	O yog lα tα?
Did you have a good day mummy?	O yog lα mα? 
I put down my bag	Mə yαb αê bαûm nsi 
I am going to wash my hands	Mə nɛ̌ n sog αê mbu 
My mum gave me the food	Mα α fα caŋ məè 
Thanks mum	Mə lαêbtə mα α 
I sat down and ate	Mə tswə̂ nsi njʉ caŋ 
I greeted my elder	Mə caèʼtə̌ nzəè αèm 
I greeted my younger brother	Mə caèʼtə è ntʉ̂ ʼnjaèm αm 
The school is finished	Ŋwaèʼni mi 
My school bag is heavy	Bαûm ŋwaèʼni αm lɛèlə 
My pen is lost	Kʉ̂ dfi sαm bi 
Students are in a row	Ghaŋwaèʼni tsin nka 
The teacher whistled	Ngaètswitə̌ tɔ ndɔ 
We sang the national anthem	Bαg yub kwi bʉèʼngɔè 
Good morning daddy	Nkə̂ bnjʉ̂ məèbwɔ̂ mbαû tα 
Good morning Sir	Nkə̂ bnjʉ̂ məèbwɔ̂ mbαû tα 
Good morning mummy 	Nkə̂ bnjʉ̂ məèbwɔ̂ mbαû mα 
Good morning madam	Nkə̂ bnjʉ̂ məèbwɔ̂ mbαû mα 
Good evening my brother	Yog məèbwɔ mbαû mfɛ̂ l αèm 
Good evening Ngonnco	Yog məèbwɔ mbαû Ngonnco 
The child has diarrhea	Koŋbam cʉb mɛn 
My mother has malaria	Saŋtəwud cʉb mα α 
Nəènαèju has constipation	Bammba cʉb Nəènαèju 
Chickenpox is not good	Ngʉnmfəèn kə̂ ʼ bwɔ 
I have colic	Bam sαm tad 
I am constipated 	Bam sαm tad 
Ngaèkoʼ has abscess	Mαêmbαn cʉb Ngaèkoʼ 
How?	Ndʉ̂ kə? 
How are the news?	Cɔè bə αê ndʉ̂ kə? 
How is your news?	Zin cɔ̂ bə αê ndʉ̂ kə? 
Your news is good?	Zin cɔ̌ fi αè? 
How are you?	A bə αê ndʉ̂ kə? 
The news is fairly good	Cɔ̌ naʼ mfi 
The news is very good	Cɔ̌ fi kwaèʼ məèbwɔ 
I had a child	Mə fon taèʼ mɛn 
I passed my exam	Mə cʉαû yαèm laèŋtəè 
Yes, my son	Ŋ̂ mə mɛn αèm 
Yes, my daughter	Ŋ̂ mə ngon αèm 
Yes, gentleman	Ŋ̂ mə mfʉαûg ncuè 
My wife is still sick	Nzwi αm cwɛ̌ d ngon bə̂ nə ghonə
My wife is not cured yet	Nzwi αèm kə̂ ʼ yog njatə 
It’s not going even a little	A kə̂ ʼ zin mbαè mətsili 
The news is not good	Cɔè kə̂ ʼ fi 
Is not going	A kə̂ ʼ zin 
I come the day of funerals	Məè səèʼ αê leʼ savʉ 
Today is the day of the market	Sɛ̂ nni bə αê leʼ ntαênə 
We go to the village market	Bαg nɛn αê ntαên laʼ 
There are plenty of people at the market	Bəènntʉ̌ n yαm ntαênə 
The car is full	Yaŋbaʼ dun tsə 
I take the bike	Məè loʼ αê bambwogə 
There are many sellers	Ghaswɛ̌ n ghaʼmbu 
Buyers are jostling each other	Ghajun nkə mfəd dʉʼ 
Thieves are prowling	Nguαntαn nkə nkaŋtə 
I market peanuts	Yαm juntαn bə αê kəènaè 
Do not go to the market without money	Kαê nɛ̌ n ntαên kəè nkαb 
Clothes are available at the booths	Nzwə lα wantαên nzwə 
There is a lot of fly in the butcher’s shop	Nzəènzə̌ dun wambαb 
There are lot of goods in the stands	Cuntαn dun wantαnə 
Good merchandise flows alone	Juntαên ntʉ̌ n swɛn wul i 
Machetes, knives are goods	Nywi, mbi bə αê cuntαnə 
The chick seller buys the raven	Ntangαb ta saʼbuʼu 
Yam seller has a basket	Nswɛnbəʼ ghʉ̌ ntsi 
Our goat seller is rich	Yαg ntanbwə zi 
The salt seller fears the rain	Ntangwa nkə mbwog αê mbaèŋ 
Merchants wait for profit or loss	O nkə nta ntαnə, o beb bin kəè bi lo
I am going to the market	Məè nɛn αê ntαnə 
I am coming back from the market	Məè fə αê ntαnə 
Be vigilant at the market	Kə̌ nzətə tɛèdntαnə 
Everyone has his counter	Mbαè wəlo ghʉ̌ zəè nkoʼntαnə 
The stand of imported objects	Ndαêntαên cu məèkalə 
Without money do not go to the market	Kəè swɛn, kəè jun kα nɛn ntαnə 
I understood well	Mə juʼ kwaʼ məèbwɔ 
Yes, I agree	Ŋ̂ , ncu bə αê ncʉʼ 
Yes my daughter	ŋ̂ , mə ngon αèm 
Yes my son	ŋ̂ , mə shuèm αèm 
Welcome Mbʉ̂ ʼ bu	Mbʉ̂ ʼ bu, sə̌ ʼ məèbwɔ 
Enjoy your meal	A dʉ̂ mtə mbαè 
Good appetite to you	A cʉαê ncuè u mbαè 
Good night to you	Zi məèbwɔ̂ mbαè 
Have a good stay	Tswə məèbwɔ 
I wish to you a good stay	Tswə məèbwɔ mbαè 
Have good handwritten	Ki ju məèbwɔ mbαè 
I love work	Mə num nkɔ̂ fàʼ 
I know how to worship God	Mə lɛ̂ n nəè fα wud Nsi 
I know how to obey	Mə num njuʼ ncuè 
I do not defame anyone	Mə kə̂ ʼ bə tana mɛèn 
I know kà and kəèsoè	Mə lɛn kà mbαè kəèsoè 
I know how to dance ndαènzi	Mə lɛn nəè nyaŋ ndαènzi 
The mask dance well the lali	Kasə bwɔ bo lαêli 
Do not go to the farm without hoe	Kαê nɛ̌ n cwɛd kə sofàʼ 
Harvest the plantain with the machete	Wad kəèlɔè bo nywi 
Do not run away from the police if you see him	O njən ntoŋnku kαê kʉè 
The Ngàkà has products	Ngàkà bə̂ ngʉ̂ mfu 
The bricklayer is strong	Nkudbaʼ num nta 
The macabo itches	Kuʼka num njogə 
The old palm wine is acid	Nduʼ bə nzi ndα ncʉαgə 
Cell-phones are good for workers	Kαêbzib bwɔ ngàfàʼ 
D not whistle at night	Kαê kə ntɔ fin tɛdtswəʼ 
The voice of ndʉ̂ ʼ CEPOM goes far	Nzə ndʉ̂ ʼ CEPOM num nɛ̂ n nəèsαè
I am a gentleman	Mə bə αê mαndum 
My father is a gentleman	Tα α bə αê mαndum 
My sister is woman	Ngon mα α bə αê mɛènnzwi 
My mother is woman	Mα α bə αê mɛènnzwi 
I have panties	Mə ghʉ̌ cə̌ ʼnku 
My father has a trouser	Tα α ghʉ̌ nsαè cə̌ ʼnku 
My sister has a dress	Ngon mα α ghʉ̌ kαèbαè 
Even my mother has dresses	Mbα mα α ghʉ̌ kαèbαè 
I wash the socks	Mə sog αê zinkətoʼo 
My knit is clean	Zi kum sαm lαn 
My father has boots	Tα α ghʉ̌ nkoŋkəènà 
I wash my mother’s sandals	Mə sog αê nkəbαb mα α 
I have tee-shirt	Mə ghʉ̌ tunzwə 
My clothe is torn	Yαm nzwə fàgtə̌ 
Here is the school uniform	Nzwə̂ ŋwàʼni lα 
Here is the clothe for cold	Nzwə̂ mfʉαg lα 
My father has a red cap	Tα α ghʉ̌ bαè cəèʼ 
My mother has a scarf	Mα α ghʉ̌ lamtu 
We have a black dog	bαg ghʉ̌ nəsɛ̂ n mbʉ 
The cat hates the mouse	Busi bαûn cedku 
Goat and sheep eat grass	Mbwə bo njʉmbwə fɛd nəènαè 
The buffalo likes to run	Nguayid kɔ̌ ndə 
The hyena ate our goat	Ŋaŋom fɛd mbwə̂ yαg 
The crow flies hard	Saʼmbuʼu fəd nəèta 
The big likes excrement	Ngʉnyαûm kɔ̌ mbɛd 
The bird looks like the hen	Saŋ futə ngαb 
Zizi scold tutu	Zizi cobtə tutu 
Cokod counts the furrows	Cokod siaŋ ngɔ̂ nα 
We have a family	Bαg ghʉ̌ tunndα 
My father is a boy	Tα α bə αê mɛnmαndum 
My mother is a dressmaker	Mα α bə αê tamnzwə 
My elder brother is strong	Ncʉαèmbwə αûm ta 
My younger is a girl	Ntʉ̂ ʼnjàm αm bə αê mɛènnzwi 
I am a man	Mə bə αê mαndum 
You are a woman	O bə αê mɛènnzwi 
My grandfather is tired	Tα α zə njàm bod 
I have a grandfather	Mə kɔ̌ mα α zəè ndʉb 
My grandfather is living in Bazou	Tα α zə njàm bə αê jʉè 
My paternal sister loves me	Ngon tα α kɔè αm 
My brother is tired	Nshum tα α bod tsə 
I have my maternal brothers	Mə ghʉ̌ bə̌ n mα cαm 
I have my paternal brothers	Mə ghʉ̌ bə̌ n tα cαm 
My elder is my uncle	Ncʉαèmbwə αèm bə αê nzəè αèm 
My younger brother fell	Ntʉ̂ ʼnjàm αm tamnsi 
The elder raises his brother	Ncʉαèmbwə bʉʼ mfɛ̂ l i 
In the morning, did you have a good night?	Nkə̂ bnjʉ, o zi lα tα 
In the evening, did you have a good day?	Mfə̌ dnjʉ, o yog lα mα 
We have a family meeting	Bαg ghʉ̌ ntsəʼtəè tunndα 
Meeting once a year	Ntsəʼtəè yoŋncʉ̌ ʼ tamnguʼ 
The family has a meeting	Tunndαê bə αê mbuèmtəè 
My father has a shoulder bag	Tα α ghʉ̌ bαûm zib 
My grandmother has a stick	Mα α zəè ndʉb ghʉ̌ kog 
Ngaʼnzəè is the first born	Ngaʼnzəè bə αê tuswə 
Family peace gives joy to the heart	Fitə bə̂ ngʉ̂ tunndα tsiaŋtəè 
Our country has enough food	Ngɔ yαg ghʉ̌ jujʉ 
The are several meals on the menu	Caŋ bə αê nzə̌ nzəè 
I like tagnjab, here it is	Mə kɔ̌ tagnjαb, a lα 
I like fufu with cɛn sauce	Mə kɔ̌ bαên sogcɛèn 
Koki is good with macabo	Kəkʉα bwɔ bo kuʼkà 
I like taro	Məè jʉ α tɔ̌ mfɔ mbα 
Banana and avocado	Kəèmbuʼtuʼ bo biha 
Bombitag come from south	Bombeètagə fə αê ntɛn 
Fufu is appetizing	Bαênnkwʉ bə αê cʉèαncu 
Banana does not have support	Kəèmbuʼtuʼ kəʼ ghʉ̌ tom 
Peanut is good for white sauce	Kəèna bwɔ̌ sogfogtab 
Cassava is attached detached	Cʉαèshum bə αê bokwud boke 
Everyone’s village is bone-free meat	Ngɔ̌ bαè mɛèn bə αê mbαb kəè vogə
It is the potato which left to be eaten raw	Bəèloŋ bαm bo fɛl i mbαg 
The mouth refuses the raw macabo	Ncu gha kuʼkà mbαg 
There is more than enough food in the market	Cujʉ tab ntαnə 
Bəʼmbemə is harder than potato	Bəʼmbemə ta ncʉαê bəèloŋ 
Bə̂ ʼləʼ has many branches	Bə̂ ʼləʼ ghʉ̌ ndɔ tsə yαmə 
Bəʼntuju is good with tagkena	Bəʼntuju bwɔ bo tagkəènà 
Tagnjab depends on melon	Tagnjαb fə αê boʼlɛnə 
The termite is not the vegetable	Ngoʼ bə̂ mbαên njαb 
Where does njabkena is coming from the market	Njαbkəènà fə yα ntαn αê? 
Rice has taken the place of beans	Nkun məèkad loʼ dʉ̌ ʼ tαênyashʉʼ 
mashed banana with red beans	Cuʼkəèlɔ bo bànkun 
Even the mud extinguishes the fire	Nzikuʼ kə̂ ʼ bə tɛ̂ d caʼ bαm nja 
We are into a new year	Bαg bə αê ntʉ̂ m nguʼswə 
I have a diploma	Mə ghʉ̌ fə̂ coʼnguʼu 
We are from harvesting	Bαg fə coʼ αê cu 
My sister got married too young	Ngon mα α nandα mɛ̂ nfi 
Too much illnesses in the world	Ngokɛd yαm ntum njʉ 
Young people suffer from AIDS	Koglog cʉb bon shum 
The TV set is on the chair	Ngʉαyən bə αê num diaŋ 
Old basket cabinet	Mbuʼnzwə ghàntsi 
Rises well my dear	Koʼ məèbwɔ̂ mbα 
My family love me	Tunndαê αm num nkɔ αm 
Telephone, TV set, radio	Kαêbzib, ngʉαyən, nkwefoŋə 
What sticks is not good	Ju nəè ŋαbə kəʼ bwɔ 
The obedient child is good	Məè mɛ̂ n njuʼ ncu bwɔ 
We are in a big family	Laʼ sαg bə αê laʼntu 
Our house has white color	Ncʉ̌ yag baʼ bə αê fogtab 
Good appetite to you	A cʉαê ncu u mbα 
Do not go to the farm without a hoe	Kαê nɛ̌ n cwɛd kə sofàʼ 
Even mud switches off fire	Nzikuʼ kə̂ ʼ bə tɛ̂ d caʼ bam nja 
I am a person	Mə bə αê mɛènntʉèn 
I have many parts of the human body	Mə ghʉ̌ nkamwʉd yαmə 
The head has two eyes	Tu ghʉ̌ miαg mbαhα 
I see with an eye	Mə kə njən nzə αê lαg 
The head has two ears	Tu ghʉ̌ ntoŋ mbαhα 
I listen with ears	Mə kə njuʼ nu αê ntoŋ 
The head has a mouth	Tu ghʉ̌ ncu 
I eat by the mouth	Mə kə njʉ caŋ αê ncu 
I speak with the mouth	Mə kə ncobtə αê ncu 
My hair is black	Nyaŋtu cαm sɛn 
The body has two arms	Wʉd ghʉ̌ mbu mbαhα 
I wear clothes with my arms	Mbu mαm nkə maʼ nzwə 
I take food with my hands	Mbu mαm nkə ndoʼ caŋ 
It’s my hands working	Mbu mαm nkə mfaʼmfàʼ 
It’s my hands washing	Mbu mαm nkə nsog ju 
I write with my hands	Mbu mαm nkə nki ju 
I carry the baby with my hands	Mbu mαm nkə nkə̂ d mɛn 
It’s my hands that sweep	Mbu mαm nkə mbeʼtə dʉʼ 
The body has fingers	Wʉd ghʉ̌ ntu mbu 
A person has two feet	Mɛènntʉ̌ n ghʉ̌ nku mbαhα 
I have a stomach and a back	Mə ghʉ̌ mvɛèn bo bàm 
My stomach is in front	Bàm sαm bə αê mbwəè 
My back is behind	Mvɛèn αm bə αê njàm 
My neck supports my head	Tɔ αm lad tu αm 
My tooth is removed	Sɔ sαm coʼ tsə 
The body has three parts	Wud ghʉ̌ ndaŋ mi ntad 
My figure looks like my father’s	Sə αm futə zə̂ tα α 
I walk on foot	Mə kə nzin αê nku 
Our house has several rooms	Bàʼ yαg ghʉ̌ ntoʼ mi yαmə 
There is a living	Toʼmu bə bwə lα 
There are many sleeping rooms	Ntoʼ zi bə yαmə 
The kitchen is in the yard	Fə̌ ʼmbwog bə αê ncundα 
The kitchen has a fireplace	Fə̌ ʼmbwog ghʉ̌ tɔ̌ mbwogə 
Plates and pots are in the kitchen	Nka bo mba bə αê fə̌ ʼmbwogə 
Our kitchen has shelves	Fə̌ ʼmbwog yαûg ghʉ̌ nkoʼndα 
The living room has a TV set and a margin guard	Toʼmu ghʉ̌ ngʉαyən mbαè nkoʼcaŋ
The living room has chairs and wooden cabinet	Toʼmu ghʉ̌ ndiaŋ mbαè nkoʼncwɛn
The rooms have wooden beds	Ntoʼzi ghʉ̌ nkunndα ncwɛn 
The picture of our father is in the living room	Sə̂ və̌ tα yαg lα toʼmu 
The toilet is not inside the house	Kod kə̂ ʼ bə tsə αê ndα 
The toilet is behind the kitchen	Kod bə αê njàm fə̌ ʼmbwogə 
Our concession has a lot of people	Laʼ sαg bə αê laʼntu 
Sun dry blocks houses are there, wooden houses are there	Bàʼcaʼ lα bwə, baʼncwɛn lα bwə 
The knives help my mother	Mbi bə̂ njwimtə mα α 
The machetes help my father	Nywi bə̂ njwimtə tα α 
We have a dog and a cat	Bαg ghʉ̌ mbʉ mbα busi 
The hen loves corn too much	Ngab kɔ̌ ngəèfəd yαmə 
I am at home	Mə bə αê ndα 
Open the door	Coʼ nzə ndα 
Turn the door flap	Kaŋ nzə ndα 
Close the door	Fʉ̌ n nzəndα 
Open the window	Coʼ tɔndα 
Close the window	Fʉ̌ n tɔndα 
I sweep the floor	Mə beʼtə αê tɛ̌ dndα 
I wash the floor	Mə sog αê tɛ̌ dndα 
I wash the plates	Mə sog αê nka 
I wash the pots	Mə sog αê mba 
I wash the spoons	Mə sog αê nduʼ 
I wash the glasses	Mə sog αê ləd 
I am thirsty	Ntʉ αm kʉ 
Give me water	Fα ntsə̌ lαê məè 
I am drinking water	Mə nu αê ntsə 
I am going to the water steam	Mə nɛn αê ntsə 
I am coming back from water stream	Mə fə αê ntsə 
Water is good	Ntsə bə αê mbwɔ ju 
The way to the water stream is long	Nzə ntsə̌ sàgə 
